1111111111111
1V010000000C1
10000111110V1
1P0011E000001
1111111111111